1111111
10PCC01
100E001
1000001
1111111