11111111111111
11111111101111
1E000111111111
1C100000000001
1111111000P111
11111111011111
1C000000000001
11111111111111