11111111111111
1C1C11C11C1111
10000111111111
1E100000000001
1111111000P111
11111111111111
1C000000000001
11111111111111