1111111111111111111111111111
111111C11111C11C11111C111111
1CCCCCC11111C11C11111CCCCC11
1C1C11C11CCCCCCCCCC11C1C1C11
1C1C11C11C11100111C11C1C1C11
1C1C11C11C10000001C11C1C1C11
1C1C11CCCC100EP001CCCC1C1C11
1C1C11C11C10000001C11C1C1C11
1C1C11C11C11111111C11C1C1C11
1C1C11C11CCCCCCCCCC11C1C1C11
1111111111111111111111111111